1 1 1 1 1 1 1 1 1 1 1 1 1 1 1 1
2 2 2 4 1 1 1 1 1 1 1 1 1 1 1 1
1 1 2 2 2 2 2 1 1 2 2 2 1 1 1 1
1 1 1 1 1 1 2 1 1 2 4 2 1 1 1 5
11 11 11 14 1 1 2 1 1 2 1 2 1 1 10 10
3 3 3 13 1 1 2 2 1 2 1 2 1 10 8 7
3 3 12 6 1 1 4 2 2 2 1 2 2 9 16 8
12 15 6 1 2 2 2 2 1 2 1 2 1 10 8 7
6 1 1 1 2 1 1 1 1 2 1 2 1 1 10 10
1 1 2 2 2 1 1 1 1 2 4 2 1 1 1 1
2 2 2 4 1 1 5 1 1 2 2 2 1 1 5 1
1 1 1 1 1 1 1 1 1 1 1 1 1 1 1 1
